16S_Ribosomal_RNA_Methyltransferase	family
AAC3	gene
AAC3-I	variant
AAC6-I	variant
AAC6-Ib	variant
AAC6-II	family
ABCAntibioticEffluxPump	family
ABC_tran	gene
ABC1	variant
ABC2_membrane	variant
Acetyltransf_1	variant
Acetyltransf_3	variant
Acetyltransf_4	variant
Acetyltransf_7	variant
Acetyltransf_8	variant
Acetyltransf_9	variant
ACR_tran	gene
Acyltransferase	family
adeA-adeI	family
adeB	gene
adeC-adeK-oprM	family
adeR	gene
adeS	gene
Aminotran_1_2	family
Aminotran_4	variant
ANT2	gene
ANT3	gene
ANT4	gene
ANT6	gene
ANT9	gene
Antibiotic_NAT	family
APH	family
APH3	gene
APH6	gene
baeR	gene
baeS	gene
BCII	gene
Beta-lactamase	family
Beta-lactamase2	family
BJP	gene
BlaB	variant
blaI	variant
blaR1	variant
CARB-PSE	family
CAT	gene
CblA	gene
CepA	gene
Cfr23RibosomalRNAMethyltransferase	family
CfxA	gene
Chloramphenicol_Acetyltransferase_CAT	family
Chloramphenicol_Efflux_Pump	family
Chloramphenicol_Phosphotransferase_CPT	family
ClassA	family
ClassB	family
ClassC-AmpC	family
ClassD	family
CMY-LAT-MOX-ACT-MIR-FOX	gene
CPT	gene
CTXM	gene
Dala_Dala_lig_C	variant
Dala_Dala_lig_N	variant
DHA	gene
DHFR_1	variant
DIM-GIM-SIM	family
emrB	gene
emrE	gene
Erm23SRibosomalRNAMethyltransferase	family
Erm38	gene
ErmA	gene
ErmB	gene
ErmC	gene
Exo	gene
FAD_binding_2	family
FluoroquinoloneResistantDNATopoisomerase	family
FmrO	gene
GES	gene
Glyoxalase	gene
GOB	gene
HTH_AraC	family
IMP	gene
IND	gene
KHM	gene
KPC	gene
L1	gene
Lactamase_B	family
Lactamase_B_2	family
LRA	gene
macA	gene
macB	gene
MacrolideGlycosyltransfer	family
marA	gene
MarR	gene
MarR_2	variant
mecR1	variant
Methyltransf_18	variant
MexA	gene
MexC	gene
MexE	gene
MexH	gene
MexW-MexI	family
MexX	gene
MFS_1	variant
MFS_3	variant
MFSAntibioticEffluxPump	family
MoxA	gene
mprF	gene
msbA	gene
NDM-CcrA	family
norA	gene
Nuc_H_symport	family
PC1	gene
phoQ	gene
QuinoloneResistanceProteinQnr	family
ramA	gene
RNDAntibioticEffluxPump	family
robA	gene
romA	gene
Sfh	gene
SHV-LEN	family
SME	gene
soxR	gene
SPM	gene
SubclassB1	family
SubclassB2	family
SubclassB3	family
TEM	gene
TetA	gene
TetA-B	family
TetA-G	family
TetD	gene
TetE	gene
TetH-TetJ	family
TetM-TetW-TetO-TetS	family
Tetracycline_Resistance_MFS_Efflux_Pump	family
Tetracycline_Resistance_Ribosomal_Protection_Protein	family
TetX	gene
TetY	gene
Tex_N	gene
Thymidylat_synt	family
Bcr_Cfla	family
EmrB	gene
MATE_efflux	family
drrA	gene
DalaDala	family
SoxR	gene
ThymSym	family
tolC	gene
Transpeptidase	family
vanA	variant
vanB	variant
vanC	variant
vanD	variant
vanH	variant
vanR	variant
vanS	variant
vanT	variant
vanW	variant
vanX	variant
vanY	variant
vanZ	variant
VEB-PER	family
VIM	gene
Whib	gene
RND_mfp	family
Dihydropteroate	family
ANT	family
Aminoglyc_resit	family
TE_Inactivator	family
Small_Multi_Drug_Res	family
Usp	gene
APH3''	variant
APH3'	variant
ArmA_Rmt	family