16Ribosomal_RNA_Methyltransferase	family
AAC3	gene
AAC3-I	variant
AAC6-I	variant
AAC6-II	variant
ABCAntibioticEffluxPump	family
adeA-adeI	family
adeB	gene
adeC-adeK-oprM	family
adeS	gene
Aminoglycoside	family
ANT	family
ANT2	gene
ANT3	gene
ANT4	gene
ANT6	gene
ANT9	gene
APH3	gene
APH3_double_prime	variant
APH3_prime	variant
APH6	gene
baeR	gene
baeS	gene
BCII	gene
BJP	gene
bla	gene
BlaB	variant
blaI	variant
blaR1	variant
CARB	family
CblA	gene
Cfr23RibosomalRNAMethyltransferase	family
CfxA	gene
ClassA	family
ClassB	family
ClassC-AmpC	family
ClassD	family
CMY-LAT-MOX-ACT-MIR-FOX	family
CMY-MOX-FOX	gene
CMY	gene
MOX	family
FOX	gene
ACT-MIR	family
ACT	gene
MIR	gene
OCH	gene
PDC	gene
CTX-M	family
DHA	gene
DIM-GIM-SIM	gene
DIM-GIM	gene
DIM	gene
GIM	gene
emrB	gene
Erm23SRibosomalRNAMethyltransferase	gene
ErmA	gene
ErmB	gene
ErmC	variant
GES	variant
GMR	gene
GOB	gene
IMI	gene
IMP	gene
ImrB	gene
IND	gene
KHM	gene
KPC	gene
L1	gene
LCR	gene
LRA-A	variant
LRA-B	variant
macA	gene
macB	gene
marA	gene
MCA	gene
MCR	gene
MCR-1	variant
MCR-3	variant
MCR-4	variant
mecR1	variant
MexA	gene
MexC	gene
MexE	gene
MexW-MexI	family
MexX	gene
MFSAntibioticEffluxPump	family
mprF	gene
msbA	gene
MSI	gene
NDM-CcrA	family
norA	gene
NPS	gene
OXA	gene
OXA-cluster1	variant
OXA-cluster2	variant
OXA-cluster3	variant
OXA-cluster4	variant
OXA-cluster5	variant
OXA-cluster6	variant
OXA-cluster7	variant
OXA-cluster8	variant
OXY	gene
PAC	gene
PER	gene
phoQ	gene
PvrR	gene
ramA	gene
RNDefflux	family
robA	gene
romA	gene
SED	gene
Sfh	family
SHV-LEN-OKP	family
SHV-LEN	family
SHV	gene
LEN	gene
OKP	gene
OKP-A	variant
OKP-B	variant
SME	gene
soxR	gene
SPM	gene
SubclassB1	family
SubclassB2	family
SubclassB3	family
TE_Destructase	gene
TEM	gene
Tet_Inactivator	family
TetA	gene
TetA-B	family
TetA-G	family
TetD	gene
TetE	gene
TetH-TetJ	family
TetH	gene
TetJ	gene
TetM-TetW-TetO-TetS	family
TetM	gene
TetW	gene
TetO	gene
TetS	gene
Tetracycline_Resistance_MFS_Efflux_Pump	family
Tetracycline_Resistance_Ribosomal_Protection_Protein	family
TetX	gene
TetY	gene
tolC	gene
vanA	variant
vanB	variant
vanC	variant
vanD	variant
vanH	variant
vanR	variant
vanS	variant
vanT	variant
vanW	variant
vanX	variant
vanY	variant
vanZ	variant
VEB	gene
VIM	gene