154989_fosA	variant
156720500_bleO	variant
1567214_ble	gene
16S_rRNA_NpmA	gene
16S_rRNA_Rmt_B	variant
16S_rRNA_Rmt_C	variant
16S_rRNA_Rmt_D	variant
16S_rRNA_Rmt_E	variant
16S_rRNA_Rmt_F	variant
16S_rRNA_Rmt_G	variant
16S_rRNA_Rmt_gen	family
16S_rRNA_Rmt_H	variant
299782349_fosC	variant
299782351_fosA	variant
354827590_fosA	variant
47473_otr	gene
485965_fosC	variant
491618165_fosA	variant
498180014_fosA	variant
AAC_2p_Ia	variant
AAC_2p_Ib	variant
AAC_2p_Ic	variant
AAC_2p_Id	variant
AAC_2p_Ie	variant
AAC_2p_IIa	variant
AAC_2p_IIb	variant
AAC_3	gene
AAC_3_I	variant
AAC_3_II	variant
AAC_3_IV	variant
AAC_3_VIa	variant
AAC_3_VIII	variant
AAC_3_XI	variant
AAC_6p_A10	variant
AAC_6p_A29	variant
AAC_6p_A30	variant
AAC_6p_A31	variant
AAC_6p_A34	variant
AAC_6p_A37	variant
AAC_6p_A40	variant
AAC_6p_A48	variant
AAC_6p_A49	variant
AAC_6p_Acine	family
AAC_6p_Entco	family
AAC_6p_Ia_fam	family
AAC_6p_Iad	variant
AAC_6p_Iak	variant
AAC_6p_Ian	variant
AAC_6p_Ib	variant
AAC_6p_Id	variant
AAC_6p_Ie	variant
AAC_6p_Ie_fam	family
AAC_6p_If	variant
AAC_6p_IIc	variant
AAC_6p_Il	family
AAC_6p_Im	variant
AAC_6p_Ip	variant
AAC_6p_Iz	variant
AAC_6p_Serra	family
AAC_6p_set_A	family
AAC_6p_Steno	family
AAC_6p_Strep	family
AAC_6p_Yersi	family
aadE-Cc	gene
ABCF_CarA	gene
ABCF_Lsa_all	family
ABCF_Msr_all	family
ABCF_OptrA	family
ABCF_producer	family
ABCF_Sal	family
ABCF_Vga_all	family
amicyc_ac_ApmA	family
ANT_2pp_Ia	variant
ANT_3pp_AadA1	variant
ANT_3pp_AadA3	variant
ANT_3pp_I	variant
ANT_3pp_II	variant
ANT_4p_I	variant
ANT_4p_Ia	variant
ANT_4p_Ib	variant
ANT_4p_II	variant
ANT_6	gene
ANT_6_aadK	variant
ANT_6_aadS	variant
ANT_6_str	variant
ANT_9	gene
APH_2pp_I_a_f_h	variant
APH_2pp_Ia	variant
APH_2pp_Ie_IVa	variant
APH_2pp_If_Ih	variant
APH_2pp_Ig	variant
APH_2pp_IIa	variant
APH_2pp_IIIa	variant
APH_3p	gene
APH_3p_A16	variant
APH_3p_I	variant
APH_3p_II	variant
APH_3p_IIIa	variant
APH_3p_IVa	variant
APH_3p_V	variant
APH_3p_VI	variant
APH_3p_VIIa	variant
APH_3p_VIII	variant
APH_3p_XV	variant
APH_3pp	gene
APH_3pp_Ia	variant
APH_3pp_Ib	variant
APH_4_Ia	variant
APH_6	gene
APH_6_Ic	variant
APH_6_Ic_gen	variant
APH_6_Steno	variant
APH_7pp_Ia	variant
APH_9_Ia	variant
APH_9_Ib	variant
betalact_A_Burk_PenA	variant
betalact_A_Burk_PenI	variant
bla_B2_CphA	gene
bla_Bc_2	gene
bla_CblA	gene
bla_CepA	gene
bla_CfxA	gene
bla_class_A	family
bla_class_B_core	family
bla_class_C	family
bla_class_D_alt	family
bla_class_D_main	family
bla_Exo	gene
bla_subclass_B1	family
bla_subclass_B2	family
bla_subclass_B3	family
bla_xUS	family
bla-A_Chryseo	family
bla-B1-FLAV	family
bla1	gene
BlaA_Yent	gene
blaACC	gene
blaACI	gene
blaACT	gene
blaADC	gene
blaAFM	gene
blaAIM	gene
blaALI	gene
blaAQU	gene
blaARL	gene
blaB	gene
blaB-IND-MUS	variant
blaBBI	gene
blaBCL	gene
blaBEL	gene
blaBES	gene
blaBIC	gene
blaBJP	gene
blaBKC	gene
blaBKC_GPC	gene
blaBPU	gene
blaCAU	gene
blaCBP	gene
blaCcrA	gene
blaCDD	gene
blaCIA	gene
blaCMA	gene
blaCME	gene
blaCMH	gene
blaCPS	gene
blaCRH	gene
blaCSA	gene
blaCTX-M	gene
blaDHA	gene
blaDIM	gene
blaDIM_SIM_IMP	gene
blaEBR	gene
BlaEC	gene
blaESP-1_fam	gene
blaFEZ	gene
blaFIM	gene
blaFONA	gene
blaFOX	gene
blaFRI	gene
blaFTU	gene
blaGES	gene
blaGIL	gene
blaGIM	gene
blaGOB	gene
BlaI_of_MRSA	family
blaIMI	gene
blaIMP	gene
blaIND	gene
blaKHM-HMB	gene
blaKLUC	gene
blaKPC	gene
blaL	gene
blaL1	gene
blaLAP	gene
blaLHK	gene
blaLUT	gene
blaMCA	gene
BlaMIR	gene
blaMSI-1_fam	family
blaMUS	gene
blaNDM	gene
blaOCH	gene
blaOXA_Campylobacter	gene
blaOXA-1_like	variant
blaOXA-10_like	variant
blaOXA-114_like	variant
blaOXA-12_like	variant
blaOXA-134_like	variant
blaOXA-143_like	variant
blaOXA-184_like	variant
blaOXA-2_like	variant
blaOXA-211_like	variant
blaOXA-213_like	variant
blaOXA-214_like	variant
blaOXA-22_like	variant
blaOXA-229_like	variant
blaOXA-23_like	variant
blaOXA-24_like	variant
blaOXA-274_like	variant
blaOXA-286_like	variant
blaOXA-364_like	variant
blaOXA-372_like	variant
blaOXA-46_like	variant
blaOXA-48_like	variant
blaOXA-493_like	variant
blaOXA-50_like	variant
blaOXA-51_like	variant
blaOXA-55_like	variant
blaOXA-576_like	variant
blaOXA-58_like	variant
blaOXA-60_like	variant
blaOXA-61_like	variant
blaOXA-62_like	variant
blaOXA-63_like	variant
blaOXA-727_like	variant
blaOXA-85_like	variant
blaOXY	gene
blaP	gene
blaPAC	gene
blaPAU	gene
blaPDC	gene
blaPDC_var	variant
blaPEDO-1_fam	family
blaPEDO-2_fam	family
blaPEDO-3_fam	family
blaPER	gene
blaPLA_ORN_TER	gene
blaPME	gene
blaPOM	gene
blaPST	gene
blaPSV	gene
blaR1_generic	family
blaRCP	gene
blaRHO	gene
blaROB	gene
blaRUB	gene
blaSCO	gene
blaSED	gene
blaSFH	gene
blaSFH_gen	variant
blaSGM	gene
blaSIM	gene
blaSME	gene
blaSPG-1_fam	family
blaSPM	gene
blaSRT	gene
blaTEM	gene
blaTHIN	gene
blaTLA	gene
blaTMB	gene
blaTTU	gene
blaTUS	gene
blaVCC	gene
blaVEB	gene
blaVIM	gene
blaZ	gene
blaZ_gen	variant
blaZ_mecC_type	variant
ble_BLMA_gen	variant
ble_BLMT	gene
ble_MBL	family
ble_Sh	gene
BlmB	gene
CAR_gen_B3	gene
CARB	gene
carbeni_gen	family
CfrAB	gene
chaper_CopP	gene
chaperon_ArsD	gene
CHL_hydrolase	family
chloram_CatA	gene
chloram_CatB	gene
chrB	gene
classA_carba	gene
classA_firm	gene
cml_V_MFS	variant
cmlB1_MFS	variant
cmx_cmrA	gene
CMY2	gene
CMY2-MIR-ACT-EC	variant
coreg_MerD	gene
D_ala_D_lac	gene
D_ala_D_lac_Ao2	variant
D_ala_D_lac_Sc	variant
D_ala_D_lac_VanA	variant
D_ala_D_lac_VanB	variant
D_ala_D_lac_VanD	variant
D_ala_D_lac_VanF	variant
D_ala_D_lac_VanI	variant
D_ala_D_lac_VanM	variant
D_ala_D_lac_VanO	variant
D_ala_D_ser	gene
D_ala_D_ser_VanC	variant
D_ala_D_ser_VanE	variant
D_ala_D_ser_VanG	variant
D_ala_D_ser_VanL	variant
D_ala_D_ser_VanN	variant
dipept_VanX	gene
efflux_CmlA	gene
efflux_Cmx	gene
efflux_OM_AdeC	gene
emrE	gene
EreA	gene
EreB	gene
EreD	gene
erm_38_23S_MT	gene
erm_A_23S_MT	gene
erm_B_23S_MT	gene
erm_C_23S_MT	gene
erm_F_23S_MT	gene
erm_SHROVE	gene
Erm23S_rRNA_broad	gene
Erm32	gene
Erm37	gene
Erm42	gene
Erm43	gene
Erm45	gene
ErmO	gene
ErmS	gene
ErmV	gene
FexA	gene
FloR	gene
fomA_AB016934.1.gene6	gene
Fos_BSH	gene
Fos_BSH_Bcer	variant
Fos_BSH_Saur	variant
Fos_BSH_Sepi	variant
Fos_GSH	gene
fos-Crono	gene
FosA	gene
fosA7	variant
FosF	gene
FosG	gene
FosK	gene
FosL	gene
FosX	gene
FOX-MOX	gene
fusB	gene
fusC	gene
fusD	gene
fusF	gene
fusid_est_FusH	gene
glycotrans_Rgt	gene
HARLDQ_not_B3	gene
HK_VanS_ACDEFG	gene
HK_VanS_B	gene
HK_VanS_O	gene
intimin_all	family
intimin_alpha	family
L2	gene
LEN	gene
linco_LnuA	gene
linco_LnuAN2	variant
linco_LnuB	gene
linco_LnuC	gene
linco_LnuD	gene
linco_LnuE	gene
linco_LnuF	gene
linco_LnuG	gene
linco_LnuP	gene
lyase_MerB	gene
macro_glyco_Mgt	gene
macrolide_MefA	gene
macrolide_MefB	gene
macrolide_MefC	gene
macrolide_MefEN2	gene
macrolide_MphA	gene
macrolide_MphB	gene
macrolide_MphC	gene
macrolide_MphE	gene
macrolide_MphF	gene
MATE_multi_MepA	gene
MATE_multi_NorM	gene
MECA_PBP2A	variant
MECA_pure	gene
MECA1_pure	variant
MECA2_pure	variant
MECB_PBP	gene
MECC_PBP	gene
MECD_PBP	gene
MecI_of_mecA	gene
MecI_of_mecC	gene
merT_RC607	gene
MexE	gene
MFS_efflux_PexA	gene
MFS_efflux_tcmA	gene
MOX_CMY1_fam	gene
MPH_3	gene
MsrSA	gene
MupA	gene
MupB	gene
myrA	gene
NimABCDEF	gene
NimIJ	gene
nosihep_NshR	gene
NshR_TsnR	gene
OKP	gene
OqxA_adapt_sub	gene
penta_rpt_QnrA	gene
penta_rpt_QnrAS	variant
penta_rpt_QnrB	gene
penta_rpt_QnrC	gene
penta_rpt_QnrD	gene
penta_rpt_QnrE	gene
penta_rpt_QnrS	gene
penta_rpt_QnrVC	gene
PF04439	gene
phenyl_MerG	gene
phos_trans_CPT	gene
poly_MCR3_broad	variant
polymyxin_MCR1	variant
polymyxin_MCR2	variant
polymyxin_MCR3	variant
polymyxin_MCR4	variant
polymyxin_MCR5	variant
polymyxin_MCR6	variant
polymyxin_MCR7	variant
polymyxin_MCR8	variant
polymyxin_MCR9	variant
PRK13747.1	gene
PRK13752.1	gene
PSE	gene
qac_MFS_AB	gene
qac_SMR_C	gene
qac_SMR_G	gene
qac_SMR_H	gene
qac_SMR_J	gene
QacCGHJ	gene
qepA	gene
ribo_prot_ABC_F	variant
rif_mono_Iri	gene
rif_monoox	gene
rifampin_ARR	gene
rifampin_ARR_Ms	gene
rifampin_ARR_Sa	gene
RND_adapt_MexA	gene
RND_perm_OqxB	gene
RPH_KJ151292.1	gene
rRNA_meth_EmtA	gene
RTG	gene
sat2	variant
sat3	variant
sat4	variant
self_FomB_kinase	gene
self_GT_OleI	gene
self_KamB	gene
sensor_BlaR1	gene
sensor_MecR1	gene
Shiga_Stx1A	gene
Shiga_Stx1B	gene
Shiga_Stx2A	gene
Shiga_Stx2B	gene
SHV	gene
SHV_LEN_OKP	family
SMB1_fam	family
SMR_efflux_smr	gene
SMR_qac_bcrB	variant
SMR_qac_bcrC	variant
SMR_qac_E	gene
SMR_qac_FL	variant
SMR_qac_G2	variant
SMR_qac_int	gene
SMR_qac_K	gene
SMR_qac_pB8	variant
stat	gene
stregra_B_VgbA	gene
stregra_B_VgbB	gene
stregram_VatA	gene
stregram_VatC	gene
stregram_VatD	gene
stregram_VatE	gene
stregram_VatF	gene
stregram_VatH	gene
stregram_VatI	gene
SubclassA2	family
Sul1	variant
Sul2	variant
Sul3	variant
Sul4	variant
tet_ABC_46_A	gene
tet_ABC_46_B	gene
tet_ABC_AB_A	gene
tet_ABC_AB_B	gene
tet_destruct	family
tet_MFS_38	gene
tet_MFS_40	gene
tet_MFS_42	gene
tet_MFS_43	gene
tet_MFS_45	gene
tet_MFS_A	gene
tet_MFS_A_B_C_D	variant
tet_MFS_B	gene
tet_MFS_C	gene
tet_MFS_D	gene
tet_MFS_E	gene
tet_MFS_G	gene
tet_MFS_H	gene
tet_MFS_H_J	family
tet_MFS_J	gene
tet_MFS_K	gene
tet_MFS_L	gene
tet_MFS_L_K_45	family
tet_MFS_OtrB	gene
tet_MFS_P_a	gene
tet_MFS_Tcr3	gene
tet_MFS_V	gene
tet_MFS_Y	gene
tet_monoox_X	gene
tet_NaH_anti_35	gene
tet_protect	family
tet_protect_M	gene
tet_protect_M_W	family
tet_protect_Q	gene
tet_prtrans_34	variant
tet_redox_37	variant
TIGR02052	gene
TIGR02053	gene
TlmB	gene
toxin_EAST1	gene
trans_MerF	gene
trans_reg_VanU	gene
transloc_TIR	gene
transport_merC	gene
trim_DfrA1_like	variant
trim_DfrA1_rpt	variant
trim_DfrA10	variant
trim_DfrA12	variant
trim_DfrA13_A21	variant
trim_DfrA18	variant
trim_DfrA19	variant
trim_DfrA20	variant
trim_DfrA23	variant
trim_DfrA24	variant
trim_DfrA26	variant
trim_DfrA3	variant
trim_DfrA35	variant
trim_DfrA36	variant
trim_DfrA3b	variant
trim_DfrA8	variant
trim_DfrA9	variant
trim_DfrB	gene
trim_DfrC	gene
trim_DfrD	gene
trim_DfrDGK	family
trim_DfrE	gene
trim_DfrF	gene
trim_DfrG	gene
trim_DfrI	gene
VanC1_ser_lig	gene
vanH_Agroup	family
vanH_gen	variant
vanH-Ac1	variant
vanH-Amyco	variant
vanH-D	variant
vanH-Sc	variant
vanJ	gene
vanR_ACDEGLN	family
vanR_FM	family
vanR-A	family
vanR-B	variant
vanR-C	variant
vanR-D	variant
vanR-O	variant
vanT-CELN	family
vanT-G-Cterm	family
vanT-L-cat	family
vanT-L-mem	family
vanW-B	family
vanW-G	family
vanW-gen	family
vanXY	family
vanXY_G	variant
vanY_AFMPt	variant
vanY_BG	family
vanY_far	variant
vanY_of_D	variant
vanZ-A	family
vanZ-F	family
vanZ-Pt	variant
VarG_fam_MBL	family
Vat_ABCDEFH	family
viomycin_Vph	gene
zbmA	gene